111111111111
000000010001
111111110001
101100000001
100001110101
110111111111
