111111111111111101111
000000000000000000011
111111011111110001000
101111010000010001011
101111000101000100001
101111111101111111111
100000000001111111111
101111111111111111111
